#...............................#
#............TT.................#
#............###................#
#............########...........#
#......###......................#
#...............................#
#....................___........#
#...............................#
#...P...........................#
#################################